sobre=about
depois=after
quase=almost
tambem=also
sempre=always
bonito=beautiful
porque=because
antes=before
corpo=body
cidade=city
mas=but
dia=day
todo mundo=everybody
tudo=everything
todo lugar=everywhere
longe=far
primeiro=first
para=for
para sempre=forever
bom=good
feliz=happy
como=how
ultimo=last
muitos=many
próximo=near
nunca=never
novo=new
agora=now
alguma coisa=something
alguns momentos=sometimes